24 24
########################
#####..............#####
###..................###
##....................##
##...+................##
##........####.........#
##.......####..........#
###.....###......##....#
###.....##......####...#
###.....##......####...#
###.....###......##....#
##.......#####.........#
#.........#####.......##
#....##......###.....###
#...####......##.....###
#...####......##.....###
#....##......###.....###
#..........####.......##
#.........####........##
##................+...##
##....................##
###..................###
#####..............#####
########################